25x25

g1 g1 g1 g1 g1 g1 g1 g1 g1 g1 g1 g1 g1 g1 g1 g1 g1 g1 g1 g1 g1 g1 g1 g1 g1 
g1 e3 s2 s2 s2 s2 s2 s2 s2 s2 s2 t0 s2 s2 s2 s2 s2 s2 s2 s2 s2 s2 s2 c0 g1 
g1 g1 g1 g1 g1 g1 g1 g1 g1 g1 g1 s1 g1 g1 g1 g1 g1 g1 g1 g1 g1 g1 g1 s1 g1 
g1 g1 g1 g1 g1 g1 g1 g1 g1 g1 g1 s1 g1 g1 g1 g1 g1 g1 g1 g1 g1 g1 g1 s1 g1 
g1 g1 g1 g1 g1 g1 g1 g1 g1 g1 g1 s1 g1 g1 g1 g1 g1 g1 g1 g1 g1 g1 g1 s1 g1 
g1 g1 g1 g1 g1 e2 g1 g1 g1 g1 g1 s1 g1 g1 g1 g1 g1 g1 g1 g1 g1 g1 g1 s1 g1 
g1 g1 g1 g1 g1 s1 g1 g1 g1 g1 g1 s1 g1 g1 g1 g1 g1 g1 g1 g1 g1 g1 g1 s1 g1 
g1 g1 g1 g1 g1 s1 g1 g1 g1 g1 g1 s1 g1 g1 g1 g1 g1 g1 g1 g1 g1 g1 g1 s1 g1 
g1 e3 s2 s2 s2 t2 s2 s2 s2 s2 s2 x1 s2 s2 s2 s2 s2 e1 g1 g1 g1 g1 g1 s1 g1 
g1 g1 g1 g1 g1 g1 g1 g1 g1 g1 g1 s1 g1 g1 g1 g1 g1 g1 g1 g1 g1 g1 g1 s1 g1 
g1 g1 g1 g1 g1 g1 g1 g1 g1 g1 g1 s1 g1 g1 g1 g1 g1 g1 g1 g1 g1 g1 g1 s1 g1 
g1 g1 g1 g1 g1 g1 g1 g1 g1 g1 g1 s1 g1 g1 g1 g1 g1 g1 g1 g1 g1 g1 g1 s1 g1 
g1 g1 g1 c1 s2 s2 s2 s2 s2 s2 s2 t3 g1 g1 g1 g1 g1 g1 g1 g1 g1 g1 g1 s1 g1 
g1 g1 g1 s1 g1 g1 g1 g1 g1 g1 g1 s1 g1 g1 g1 g1 g1 g1 g1 g1 g1 g1 g1 s1 g1 
g1 g1 g1 s1 g1 g1 g1 g1 g1 g1 g1 c2 t0 s2 s2 s2 s2 s2 s2 s2 s2 s2 s2 c3 g1 
g1 g1 g1 s1 g1 g1 g1 g1 g1 g1 g1 g1 s1 g1 g1 g1 g1 g1 g1 g1 g1 g1 g1 g1 g1 
g1 g1 g1 s1 g1 g1 g1 g1 g1 g1 g1 g1 s1 g1 g1 g1 g1 g1 g1 g1 g1 g1 g1 g1 g1 
g1 g1 g1 s1 g1 g1 g1 g1 g1 g1 g1 g1 s1 g1 g1 g1 g1 g1 g1 g1 g1 g1 g1 g1 g1 
g1 g1 g1 s1 g1 g1 g1 g1 g1 g1 g1 g1 s1 g1 g1 g1 g1 g1 g1 g1 g1 g1 g1 g1 g1 
g1 g1 g1 s1 g1 g1 g1 g1 g1 g1 g1 g1 t1 s2 s2 s2 s2 s2 e1 g1 g1 g1 g1 g1 g1 
g1 g1 g1 s1 g1 g1 g1 g1 g1 g1 g1 g1 s1 g1 g1 g1 g1 g1 g1 g1 g1 g1 g1 g1 g1 
g1 g1 g1 c2 s2 s2 s2 s2 s2 s2 s2 s2 t3 g1 g1 g1 g1 g1 g1 g1 g1 g1 g1 g1 g1 
g1 g1 g1 g1 g1 g1 g1 g1 g1 g1 g1 g1 s1 g1 g1 g1 g1 g1 g1 g1 g1 g1 g1 g1 g1 
g1 g1 g1 g1 g1 g1 g1 g1 g1 g1 g1 g1 s1 g1 g1 g1 g1 g1 g1 g1 g1 g1 g1 g1 g1 
g1 g1 g1 g1 g1 g1 g1 g1 g1 g1 g1 g1 s1 g1 g1 g1 g1 g1 g1 g1 g1 g1 g1 g1 g1 